WWWWSWSWWWWSSSSWSSWW
WCETWXEESXEEEWWWTEXW
SEHWWEESSTWWEXTSSEES
STEWTXEWTWWEEESESETW
WEEEWEEEXEWESEETEEWS
WWEEEEEWWXEESSEWEXTW
WSWEESEEWTSESXEEEEWW
STSESTWEESEEEEEWWESW
SXEEEXWEEEWEEWETWEES
WWEESEEWEEXEWWESTWES
WSSEEEEEEEEWWSEEXSEW
SWWSWTEEWWEWSTESESEW
WSTWEEEWTTSEEWEEESEW
WWXEESEEXXWEEEWEEEES
WEEESSWEEEEWWEWXEWWS
WWEWSTWEWWETSEEEEEWS
SEEWEXEEEWESEEWWSWWW
WWEEEWEEWEEEEWEXXTTW
SWWEEEEEEEWWEEXXXTTW
WSWWWSSSSWWSWSWWSSSS